demo level
overworld
0 15 353 263 263 263 353 17 0 0 0 0 0 0 0 0 0 0 0 
0 18 19 1 1 1 19 20 0 0 0 0 0 0 0 0 0 0 0 
0 18 19 1 19 19 19 20 0 0 0 0 0 0 0 0 0 0 0 
0 18 19 19 19 19 19 20 0 0 0 0 0 0 0 0 0 0 0 
0 21 22 22 22 22 22 23 0 0 0 0 0 0 0 0 0 0 0 
0 0 0 0 0 0 0 0 0 0 0 87 88 89 0 0 0 0 0 
0 0 0 0 0 0 0 0 0 0 0 90 91 92 0 0 0 0 0 
0 0 0 0 0 0 0 0 0 0 0 93 94 95 0 0 0 0 0 
0 0 0 0 0 0 0 0 0 0 0 96 97 98 0 0 0 0 0 
0 0 0 0 0 0 0 0 0 0 0 99 100 101 0 0 0 0 0 
0 0 0 0 0 0 0 0 0 0 0 102 103 104 0 0 0 0 0 
0 0 0 0 0 0 0 0 0 0 0 0 0 0 0 0 0 0 0 
0 0 0 0 0 0 0 0 0 0 0 0 0 0 0 0 0 0 0 
0 0 0 0 0 0 0 0 0 0 0 0 0 0 0 0 0 0 0 
0 0 0 0 0 0 0 0 0 0 0 0 0 0 0 0 0 0 0 
0 0 0 0 0 0 0 0 0 0 96 97 98 0 0 0 0 0 0 
0 0 0 0 0 0 0 0 0 0 99 100 101 0 0 0 0 0 0 
0 0 0 0 0 0 0 0 0 0 102 103 104 0 0 0 0 0 0 
0 0 0 0 0 0 0 0 0 0 0 0 0 0 0 0 0 0 0 
0 0 0 0 0 0 0 0 0 0 0 0 0 0 0 0 0 0 0 








































































































































































































































































































































































---
---
---
---
---
---
---
