demo level
overworld
20 20
---
hero 100 100
---
0 15 353 263 263 263 353 17 0 0 0 0 0 0 0 0 0 0 0 
0 18 627 628 628 628 629 20 0 0 0 0 0 0 0 0 0 0 0 
0 18 19 19 19 19 19 20 0 0 0 0 0 0 0 0 0 0 0 
0 18 19 19 19 19 19 20 0 0 0 0 0 0 0 0 0 0 0 
0 21 22 22 22 22 22 23 0 0 0 0 0 0 0 0 0 0 0 
0 0 0 0 0 0 0 0 0 0 0 87 88 89 0 0 0 0 0 
0 0 0 0 0 0 0 0 0 0 0 90 91 92 0 0 0 0 0 
0 0 0 0 0 0 0 0 0 0 0 93 94 95 0 0 0 0 0 
0 0 0 0 0 0 0 0 0 0 0 96 97 98 0 0 0 0 0 
0 0 0 0 0 0 0 0 0 0 0 99 100 101 0 0 0 0 0 
0 0 0 0 0 0 0 0 0 0 0 102 103 104 0 0 0 0 0 
0 0 0 0 0 0 0 0 0 0 0 0 0 0 0 0 0 0 0 
0 0 0 0 0 0 0 0 0 0 87 88 89 0 0 0 0 0 0 
0 0 0 0 0 0 0 0 0 0 90 91 92 0 0 0 0 0 0 
0 0 0 0 0 0 0 0 0 0 93 94 95 0 0 0 0 0 0 
0 0 0 0 0 0 0 0 0 0 96 97 98 0 0 0 0 0 0 
0 0 0 0 0 0 0 0 0 0 99 100 101 0 0 0 0 0 0 
0 0 0 0 0 0 0 0 0 0 102 103 104 0 0 0 0 0 0 
0 0 0 0 0 0 0 0 0 0 0 0 0 0 0 0 0 0 0 
0 0 0 0 0 0 0 0 0 0 0 0 0 0 0 0 0 0 0 
---
-1 -1 -1 -1 -1 -1 -1 -1 -1 -1 -1 -1 -1 -1 -1 -1 -1 -1 -1 -1 
-1 -1 -1 -1 -1 -1 -1 -1 -1 -1 -1 -1 -1 -1 -1 -1 -1 -1 -1 -1 
-1 -1 -1 626 626 -1 -1 -1 -1 -1 -1 -1 -1 -1 -1 -1 -1 -1 -1 -1 
-1 -1 -1 -1 -1 626 80 -1 -1 -1 -1 -1 -1 -1 -1 -1 -1 -1 -1 -1 
-1 -1 -1 -1 -1 -1 -1 -1 -1 -1 -1 -1 -1 -1 -1 -1 -1 -1 -1 -1 
-1 -1 -1 -1 -1 -1 -1 -1 -1 -1 -1 -1 -1 -1 -1 -1 -1 -1 -1 -1 
-1 -1 -1 -1 -1 -1 -1 -1 -1 -1 -1 -1 -1 -1 -1 -1 -1 -1 -1 -1 
-1 -1 -1 -1 -1 -1 -1 -1 -1 -1 -1 -1 -1 -1 -1 -1 -1 -1 -1 -1 
-1 -1 -1 -1 -1 -1 -1 -1 -1 -1 -1 108 -1 -1 -1 -1 -1 -1 -1 -1 
-1 -1 -1 -1 -1 -1 -1 -1 -1 -1 -1 109 106 -1 168 -1 -1 -1 -1 -1 
-1 -1 -1 -1 -1 -1 -1 -1 -1 -1 -1 109 -1 -1 -1 -1 -1 -1 -1 -1 
-1 -1 -1 -1 -1 203 -1 -1 -1 -1 -1 -1 -1 -1 -1 -1 -1 -1 -1 -1 
-1 -1 -1 -1 -1 -1 -1 -1 -1 -1 -1 -1 -1 -1 -1 -1 -1 -1 -1 -1 
-1 -1 -1 -1 -1 -1 -1 -1 -1 -1 -1 -1 -1 -1 -1 -1 -1 -1 -1 -1 
-1 -1 -1 -1 -1 -1 -1 -1 -1 -1 -1 -1 -1 -1 -1 -1 -1 -1 -1 -1 
-1 -1 -1 -1 -1 -1 -1 -1 -1 -1 -1 -1 -1 -1 -1 -1 -1 -1 -1 -1 
-1 173 -1 173 -1 173 -1 173 -1 -1 -1 105 -1 -1 -1 -1 -1 -1 -1 -1 
-1 -1 -1 -1 -1 -1 -1 -1 -1 -1 -1 -1 -1 -1 -1 -1 -1 -1 -1 -1 
-1 -1 -1 -1 -1 -1 -1 -1 -1 -1 -1 -1 -1 -1 -1 -1 -1 -1 -1 -1 
---
---
